@@@@@@@@@@@@@@
@@@......@@@@@
@@@...@@@@@@@@
@@@@@.....@@@@
@@@@@@....@@@@
@@@....@@@@@@@
@@@@@@....@@@@
@@@@@@@@@@@@@@