@@@@@@@@@@@@@@@@@@@@@@@@@@@@@@@@@@@@@@@@@@@@@@@@@@@@@@@@@@@@@@@@@@@@@@@@@@@@@@@@@@@@@@@@@@@@@@@@@@@@@@@@@@@@@@@@@@@@@@@@@@@@@@@@
@....................................................@@..@@@@@@@@.....................@@@.....................@@...............@
@...................................................@@@@@@@@@@@@@@...................@@@@@..............@@@@@@@@...............@
@...............@@.................................@@@@@@@@@@@@@@@@@@................@@@@@............@@@@@@@@@@...............@
@..............@@@@................................@@@@@@@@@@@@@@@@@@@.................@@..........@@@@@@@@@@@@................@
@.............@@@@@@@@.........@@@..................@@..@@@@@@@@@@@@@@.......................@@@@@@@@@@@@@@@@@.................@
@.............@@@@@@@@@........@@@...........................@@@@@@@@@......................@@@@@@@@@@@@@@@@@..................@
@.............@@@@@@@@@........@@@@...........................@@@@@@@@@.....................@@@@@@@@@@..@@@@...................@
@.............@@@@@@@@.........@@@@@..........................@@@@@@@@@@.....................@@@@@@@@....@@....................@
@....@@@.......@@@@@@.....@@..@@@@@@@@@.......................@@@@@@@@@@.......................@@@@@@..........................@
@...@@@@@......@@@@@@....@@@@@@@@@@@@@@@@@@@@...@@@@@@........@@@@@@@@@.........................@@@@@@.........................@
@...@@@@@@....@@@@@@@@..@@@@@@@@@@@@@@@@@@@@@@@@@@@@@@@......@@@@@@@@@..........................@@@@@@.........................@
@..@@@@@@@....@@@@@@@@@@@@@@@@@@@@@@@@@@@@@@@@@@@@@@@@@.....@@@@@@@@@..........................@@@@@@@@........................@
@.@@@@@@@@.....@@@@@@@@@@@@@@@@@@@@@@@@..@@@@@@@@@@@@@@.....@@@@@@@@...................@@.....@@@@@@@@@@@......................@
@@@@@@@@@@......@@@@@@@@@@@@..@@@@@@@@....@@@@@@@@@@@@......@@@@@@@@..................@@@@...@@@@@@@@@@@@@.....................@
@@@@@@@@@@@......@@@@@@@@@.........@@@....@@@@@@@@@@@@......@@@@@@@@..................@@@@@@@@@@@@@@@@@@@@.....................@
@@@@@@@@@@@@@....@@@@@@@@...........@@....@@@@@@@@@@@@@....@@@@@@@@@..................@@@@@@@@@@@@@@@@@@@@...............@@@...@
@@@@@@@@@@@@@@....@@@@@@@...........@@@..@@@@@@@@@@@@@@@..@@@@@@@@@@..................@@@@@@@@@@@@@@@@@@@@@.............@@@@@..@
@@@@@...@@@@@@......@@@@@@...@@@@...@@@@@@@@@@@@@@@@@@@@@@@@@@@@@@@..................@@@@@@..@@@@@@@@@@@@@@.............@@@@@..@
@.@@.....@@@@........@@@@@@@@@@@@@...@@@@@@@...@@@@@@@@@@@@@@@@@@@@.................@@@@@@....@@@@@@@@@@@@.............@@@@@...@
@................@@...@@@@@@@@@@@@...@@@@@@.....@@@@@@@@@@@@@@@@@@.................@@@@@@......@@@@@@@@............@@@@@@@@....@
@...............@@@@.....@@@@@@@@....@@@@@......@@@@@@@@@@@@@@@@@@.............@@@@@@@@........@@@@@@@............@@@@@@@@.....@
@...............@@@@@.....@@@@@@....@@@@@......@@@@@@@..@@@@@@@@@@............@@@@@@@@.........@@@@@@@............@@@@@@@......@
@................@@@@.....@@@@@....@@@@@....@@@@@@@@@....@@@@@@@@@@.........@@@@@@@@@.....@@..@@@@@@@@@...........@@@@@@.......@
@................@@@@@...@@@@@.....@@@@....@@@@@@@@@......@@@@@@@@@........@@@@@@@@@.....@@@@@@@@@@@@@@@..........@@@@@@.......@
@@@@@@@.........@@@@@@@@@@@@@@......@@.....@@@@@@@@.......@@@@@@@@........@@@@@@@@@......@@@@@@@@@@@@@@@.........@@@@@@@@......@
@@@@@@@@......@@@@@@@@@@@@@@@@.............@@@@@@@@........@@@@@@.......@@@@@@@@........@@@@@@@@@@@@@@@@@......@@@@@@@@@@@@....@
@@@@@@@@.....@@@@@@@@@@@@@@@@@@............@@@@@@@@@.......@@@@@@......@@@@@@@@.........@@@@@@@@@@@@@@@@@@....@@@@@@@@@@@@@@...@
@@@@@@@.....@@@@@@@@@@@@@@@@@@@@...........@@@@@@@@@......@@@@@@@......@@@@@@@@.........@@@@@@@@@@@@@@@@@@@@@@@@@@@@@@@@@@@....@
@@@@@@@....@@@@@@@@@@@@@@@@@@@@@..........@@@@@@@@@......@@@@@@@@@......@@@@@@@@..@@.....@@@....@@@@@@@@@@@@@@@......@@@.......@
@@@@@@@@@@@@@@@@@@@@@@@@..@@@@@@.........@@@@@@@@@.......@@@@@@@@@@@.....@@@@@@@@@@@@............@@@@@@@@@@@@@.................@
@@@@@@@@@@@@@@@@@@@@@@.....@@@@@.........@@@@@@@@.........@@@@@@@@@@@....@@@@@@@@@@@@.............@@..@@@......................@
@@@@@@@@@@@@@.@@@@@@@......@@@@@.........@@@@@@@............@@@@@@@@@@...@@@@@@@@@@@@..........................................@
@@@@@@@@@@@@@@@@@@@@@.....@@@@@@@.........@@@@@..............@@@@@@@@@...@@@@@@@@@@@@..........................................@
@@@@@@@@@@@@@@@@@@@@@@....@@@@@@@.........@@@@.................@@@@@@@....@@@@@@@@@@@..........................................@
@@@@@@@@@@@@@@@@@@@@@@@...@@@@@@@.........@@@@..................@@@@@.....@@@@@@@@@@@...................@@@....................@
@...@@@@@@@.@@@@@@@@@@@....@@@@@@........@@@@@@.................@@@@.....@@@@@@@@@@@@..................@@@@@........@@@........@
@....@@@@@@@@@@@@@@..@@.....@@@@........@@@@@@@................@@@......@@@@@@@@@@@@@@.........@@@....@@@@@@......@@@@@........@
@....@@@@@@@@@@@@@.....................@@@@@@@@@...............@@......@@@@@@@@@@@@@@@.......@@@@@@..@@@@@@@.....@@@@@.........@
@....@@@@@@@@@@@@@...................@@@@@@@@@@@@@@@..................@@@@@@@@@..@@@@@@.....@@@@@@@@@@@@@@@@@...@@@@@@.........@
@...@@@@@@@@@@@@@@.................@@@@@@@@@@@@@@@@@@.................@@@@@@@@....@@@@@.....@@@@@@@@@@@@@@@@@@@@@@@@@@.........@
@...@@@@@@@@@@@@@@................@@@@@@@@@@@@@@@@@@@.................@@@@@@@.....@@@@@@.....@@@@@@@@@...@@@@@@@@@@@@@@........@
@....@@@@@@@@@@@@@.............@@@@@@@@@@@@@@@@@@@@@@@................@@@@@@@....@@@@@@@@....@@@@@@@@.....@@@@@@@@@@@@@@.......@
@.....@@@@@@@@@@@@...........@@@@@@@@@@@@@@@@@@@@@@@@@................@@@@@@@@..@@@@@@@@@....@@@@@@.......@@@@@@@@@@@@@@@......@
@.....@@@@@@@@@@@@.........@@@@@@@@@@@@@@@@..@@@@@@@@..................@@@@@@@@@@@@@@@@@@@..@@@@@@.......@@@@@@@@@@@@@@@@@.....@
@.....@@@@@@@@@@@........@@@@@@..@@@@@@@@@......@@@@...................@@@@@@@@@@@@@@@@@@@@@@@@@@........@@@@@@@@@@@@@@@@@.....@
@......@@...............@@@@@@....@@@@@@@@.............@@@@.............@@@..@@@@@@@@@@@@@@@@@@@@.......@@@@@@@@@@@@@@@@@......@
@.......................@@@@@@.....@@@..@.............@@@@@...................@@@@@@@@@@@@@@@@@@.......@@@@@@@@@...@@@@@@......@
@.......................@@@@@@...........@...........@@@@@@...................@@@@@@@@@@@@@@@@@....@@@@@@@@@........@@@@@@.....@
@........................@@@@@..........@@@.......@@@@@@@@.....@@..............@@@@@@@@@@@@@@@@...@@@@@@@@@.........@@@@@@@@@@.@
@........................@@@@...........@@@@.....@@@@@@@@.....@@@@..............@@@@@@@@@@@@@@...@@@@@@@@@@........@@@@@@@@@@@@@
@............@..........@@@@...........@@@@@....@@@@@@@@@.....@@@@@..............@@@@@@@@........@@@@@@@@@........@@@@@@@@@@@@@@
@....@@.....@@@......@@@@@@.........@@@@@@@@...@@@@@@@@@@......@@@@@..............@@@@@@.........@@@@@@@@@........@@@@@@@@@@@@.@
@...@@@@....@@@.....@@@@@@@........@@@@@@@@@@@@@@@@@@@@@.......@@@@@@.............@@@@@..........@@@@@@@@.........@@@@@@@@@@...@
@...@@@@....@@@....@@@@@@@@@.......@@@@@@@@@@@@@@@@@@@@.........@@@@@@@@..........@@@@............@@@@@@..........@@@@@@@@@....@
@....@@@...@@@@....@@@@@@@@@@......@@@@@@@@@@@@@@@@@@...........@@@@@@@@@.........@@@.............@@@@@..........@@@@@@@@@@....@
@.......@@@@@@....@@@@@@@@@@@.......@@@@@@@@@@@@@@@@............@@@@@@@@@........@@..............@@@@@........@@@@@@@@@@@@@@...@
@.......@@@@@....@@@@@@@@@@@@........@@@@@@@@@@@@@@.............@@@@@@@@........@@........@@....@@@@@@.....@@@@@@@@@@@@@@@@@@@.@
@.......@@@@@....@@@@@@@@@@@...............@@@@@@@.............@@@@@@@@.....@@@@@@.......@@@@@@@@@@@@@....@@@@@@@@@@@@@@@@@@@@@@
@.......@@@@.....@@@@@@@@@@.................@@@@@..............@@@@@@@@....@@@@@@@@......@@@@@@@@@@@@....@@@@@..@@@@@@@@@@@@@@@@
@.......@@@.......@@@@@@@@........@@@........@@@......@@........@@@@@@@....@@@@@@@@.......@@@@..........@@@@@.......@@@@@@@@@@@@
@.......@@@.......@@@@@@@........@@@@@@..............@@@@...........@@......@@@@@@.........@@..........@@@@@@........@@@@@@@@@@@
@.......@@@.......@@@@@@@..@@@@@@@@@@@@@.............@@@@@@@...................@@....................@@@@@@@@........@@@@@@@@@@@
@.......@@@@......@@@@@@@@@@@@@@@@@@@@@@@@@.........@@@@@@@@@.......................................@@@@@@@@@........@@@@@@@@@@@
@.......@@@@@@...@@@@@@@@@@@@@@@@@@@@@@@@@@@.......@@@@@@@@@@.......................................@@@@@@@@@.........@@...@@@@@
@.......@@@@@@@@@@@@@@@@@@@@@@@@@@@@@@@@@@@@......@@@@@@@@@@@.......................................@@@@@@@@@...............@@.@
@.......@@@@@@@@@@@@@@@@@@@@@..@@@@....@@@@@.....@@@@@@@@@@@@@.........................@@@...........@@@@@@@@..................@
@.......@@@@@@@@@@@@@@@@@.......@@......@@@@.....@@@@@@@@@@@@@........................@@@@@...........@@@@@@...................@
@.......@@@@@@@@@@@@@@@.........@@......@@@@.....@@@@@@..@@@@........................@@@@@@@..........@@@@@....................@
@.......@@@@@@@@@@@@@@.........@@@.....@@@@@....@@@@@@....@@@.....@@.........@@@@@@@@@@@@@@@.........@@@@@.....................@
@.......@@@@@@@@@@@@@..........@@@@..@@@@@@...@@@@@@@.....@@@@...@@@@.......@@@@@@@@@@....@@.....@@@@@@@@@.....................@
@@@.....@@@@@@@@@@@@@.........@@@@@@@@@@@....@@@@@@@......@@@@@..@@@@......@@@@@@@@@@...........@@@@@@@@@@@....................@
@@@@...@@@@@@@@@@@@@..........@@@@@@@@@@.....@@@@@@......@@@@@@...@@......@@@@@@@@@@............@@@@@@@@@@@@...............@@@.@
@@@@..@@@@@@@@@@@@@@..........@@@@@@@@@.....@@@@@@@......@@@@@@@.........@@@@@...@@@.............@@@@@@@@@@@@.............@@@@@@
@@@@..@@@@@@@@@@@@@@..........@@@@@@@@.....@@@@@@@@@......@@@@@@.........@@@@.....@@................@@@@@@@@@.............@@@@@@
@@@...@@@@@@@@@@@@@@...........@@@@@@@.....@@@@@@@@@@......@@@@@@.........@@......@@@................@@@@@@@@..............@@@.@
@.....@@@@@@@@@@@@@@.....@@......@@@@@....@@@@@@@@@@@......@@@@@@.................@@@@........@@.....@@@@@@@...................@
@.....@@@@@@@@@@@@@.....@@@@......@@@@...@@@@@@@@@@@@@.....@@@@@@.................@@@@@......@@@@...@@@@@@@....................@
@.....@@@@@@@@@@@@@.....@@@@@.....@@@@@..@@@@@@@@@@@@@......@@@@..................@@@@@......@@@@@@@@@@@@@@....................@
@......@@@@@@@@@@@@@.....@@@@.....@@@@@...@@@@@@@@@@@@.......@@....................@@@@@......@@@@@@@@@@@@.....................@
@.......@@@@@@@@@@@@.....@@@@@....@@@@@....@@@@@@..@@.......................@@.......@@@@......@@@@@@@@@.......................@
@.........@@@@@@@@@@@...@@@@@@....@@@@@@.....@@@...........................@@@@.......@@@......@@@@@@@@........................@
@..........@@@@@@@@@@@@@@@@@@@.....@@@@@@..................................@@@@.......@@@......@@@@@@@....................@@@..@
@..........@@@@@@@@@@@@@@@@@@......@@@@@@..................................@@@@@......@@@.......@@@@@@...................@@@@@.@
@..........@@@@@@@@@@@@@@@@@@......@@@@@@..................................@@@@@......@@@@......@@@@@....................@@@@@.@
@...@@@...@@@@@@@@@@@@@@@@@@.......@@@@@...................@@@.............@@@@@.....@@@@@......@@@@@....................@@@@..@
@..@@@@@@@@@@@@@@@@@@@@@@@@@......@@@@@........@@.........@@@@@.............@@@...@@@@@@@@.....@@@@@@...................@@@@...@
@..@@@@@@@@@@@@@@@@@@@@@@@@@@@@@@@@@@@.......@@@@@@.......@@@@@..................@@@@@@@@.....@@@@@@@@..............@@@@@@@....@
@.@@@@@@@@@..@@@@@@@@@@@@@@@@@@@@@@@@@......@@@@@@@@.......@@@@..................@@@@@........@@@@@@@@@@...........@@@@@@@@....@
@.@@@@@@@.....@@@@@@@@@@@@@@@@@@@@@@@@......@@@@@@@@@.......@@..................@@@@@..........@@@@@@@@@@.........@@@@@@@@@@...@
@..@@@@@......@@@@@@@@@@@@@@@@@..@@@@@@......@@@@@@@@@..........................@@@@@...........@@@@@@@@@@@@@@@..@@@@@@@@@@@@..@
@...@@@@......@@@@@...@@@@@@@@....@@@@@......@@@@@@@@@@..........................@@@............@@@..@@@@@@@@@@@@@@@@@....@@...@
@....@@@@.....@@@@.....@@@@@@......@@@......@@@@@@@@@@@@.......................................@@@....@@@@@@@@@@@@@@@..........@
@.....@@@@...@@@@@.....@@@@@...............@@@@@@@@@@@@@@.....................................@@@@....@@@@@@@@@@@@@............@
@.....@@@@@@@@@@@@@....@@@@@..............@@@@@@@@@@@@@@@@...................................@@@@@@..@@@@@@@@@@@@@.............@
@.....@@@@@@@@@@@@@....@@@@@@............@@@@@@@@@@@@@@@@@@.................................@@@@@@@@@@@@@@@@@@@@@..............@
@.....@@@@@@@@@@@@@.....@@@@@...........@@@@@@@@@@@@@@@@@@@.................................@@@@@@@@@@@@@@@@@@@@@.....@@.......@
@.....@@@@@@@@@@@@@......@@@@@.........@@@@@@@@@@@@@@@@@@@@@.......................@@......@@@@@@@@@@@@..@@@@@@@@@...@@@@......@
@......@@@@@@@@@@@@@......@@@@........@@@@@@@@@@@@@@@@@@@@@@@..............@@.....@@@@@....@@@@@@@@@@@....@@@@@@@@@..@@@@@@@@@.@
@...........@@@@@@@@@@....@@@@.......@@@@@@.....@@@@@@@@@@@@@.............@@@@....@@@@@@..@@@@@@@@@@@.....@@@@@@@@@...@@@@@@@@@@
@............@@@@@@@@@@....@@.......@@@@@@........@@@@@@@@@@@@............@@@@@...@@@@@@@@@@@@@@@@@@@......@@@@@@@....@@@@@@@@@@
@............@@@@@@@@@@.............@@@@@@.........@@@@@@@@@@@@...........@@@@@...@@@@@@@@@@@@@@@@@@@@......@@@@.....@@@@@@@@@@@
@............@@@@@@@@@..............@@@@@@@.........@@@@@@@@@@@@...........@@@@....@@@@@@@@@@@@@@@@@@@.......@@.....@@@@@..@@@@@
@...........@@@@@@@@...............@@@@@@@@@........@@@@@@@@@@@@............@@@....@@@@@@@@@@@@@@@@@@@..............@@@@....@@@@
@...........@@@@@@@............@@@@@@@@@@@@@@.......@@@@@@@@@@@@.............@@@..@@@@@@@@@@@@@@@@@@@@@.............@@@@....@@@@
@.......@@...@@@@@@...........@@@@@@@@@@@@@@@......@@@@@@@@@@@@@......@@.....@@@@@@@@@@@@@@@@@@@@@@..@@@.......@@..@@@@.....@@@@
@......@@@@...@@@@@...........@@@@@@@@@@@@@@@...@@@@@@@@@@@@@@@@.....@@@......@@@@@@@@@@@@@@@@@@@@....@@@@@..@@@@@@@@@@.....@@@@
@......@@@@@....@@.....@@.....@@@@@@@@@@@@@@@..@@@@@@@@....@@@@......@@@.......@@@@@@@@@@@@@@@@@@@.....@@@@@@@@@@@@@@@@.....@@@@
@.....@@@@@@@.........@@@@@..@@@@@@@@@@@@@@@@.@@@@@@@@..............@@@@........@@@@@@@@@@@@@@@@@@......@@@@@@@@@@@@@@@@.....@@@
@....@@@@@@@@@.......@@@@@@@@@@..@@@@@@@@@@@..@@@@@@@@..............@@@@........@@@@@@@@@@@@@@@@@.......@@@@@@@@@@@@@@@@@....@@@
@..@@@@@@@@@@@@......@@@@@@@@@....@@@@@@@@@@..@@@@@@@@..............@@@@.........@@@@@@@@@@@@@@@........@@@@@@@@@@@@@@@@@@...@@@
@.@@@@@@@@@@@@@@.....@@@@@@@@@.....@@@@@@@@@...@@@@@@@..............@@@@..........@@@@@@@@@@@@@........@@@@@@@@@..@@@@@@@@..@@@@
@.@@@@@@@@@@@@@@.....@@@@@@@@@@.....@@@@@@@@...@@@@@@@..............@@@...........@@@@@@@@@@@@.........@@@@@@@@@@@@@@@@@@..@@@@@
@.@@@@@@@@@@@@@@@....@@@@@@@@@@@.....@@@@@@@...@@@@@@@.............@@@@............@@@@@@@@@@@..........@@@@@@@@@@@@@@@@...@@@@@
@.@@@@@@@@@@@@@@@....@@@@.....@@......@@@@@@...@@@@@@@............@@@@@....@@@@@......@@@@@@@@...........@@@@@@@@@@@@@@....@@@@@
@.@@@@@@@@@@@@@@......@@..............@@@@@....@@@@@@..........@@@@@@@@...@@@@@@@......@@@@@@@............@@@@@@@@@@@@......@@.@
@.@@@@@@@@@@..........................@@@@....@@@@@@...........@@@@@@@@...@@@@@@@......@@@@@@...............@@@@@@@@@..........@
@@@@@@@@@@@...........................@@@.....@@@@.............@@@@@@@...@@@@@@@......@@@@@@@.......@@.......@@@@@@............@
@@@@@@..@@............................@@@......@@...............@@@@@....@@@@@@......@@@@@@@@@.....@@@@........@@..............@
@@@@@........................@@.......@@@@.......................@@@@....@@@@@......@@@@@@@@@@....@@@@@@.......................@
@@@@@.......................@@@@......@@@@@......................@@@@....@@@@@.....@@@@@@..@@.....@@@@@@@......................@
@.@@........................@@@@.......@@@@@...........@@.......@@@@@@....@@@@@..@@@@@@@.........@@@@@@@@@@@..@@...............@
@....@@.....................@@@@@......@@@@@..........@@@@....@@@@@@@@.....@@@@@@@@@@@@..........@@@@@@@@@@@@@@@@..............@
@...@@@@....................@@@@@@.....@@@@@.........@@@@@...@@@@@@@@@.....@@@@@@@@@@@............@@@@@@@@@@@@@@@..............@
@..@@@@@.....................@@@@@.....@@@@..........@@@@....@@@@@@@@.......@@@@@@@@@.................@@@@@@@@@@@..............@
@..@@@@@......................@@@......@@@@..........@@@.....@@@@@@@...........@@@@@...................@@....@@@...............@
@...@@@.................................@@....................@@@@..............@@@............................................@
@@@@@@@@@@@@@@@@@@@@@@@@@@@@@@@@@@@@@@@@@@@@@@@@@@@@@@@@@@@@@@@@@@@@@@@@@@@@@@@@@@@@@@@@@@@@@@@@@@@@@@@@@@@@@@@@@@@@@@@@@@@@@@@@
