@@@@@@@@@@
@@.@@@@.@@
@@..@@..@@
@..@@@@..@
@@.@@@@.@@
@@@@@@@@@@